1,,1,29,32,33,45,55,59,60,61,62,72,76,83,84,85,96,130,147,150,154,163,,,,,,,,,,,,,,,,,,,,,,,,,,,,,,,,,,,,,,,,,,
2,,22,25,26,31,34,38,39,46,49,50,51,52,53,56,57,86,88,90,91,92,93,94,131,132,149,151,152,153,,,,,,,,,,,,,,,,,,,,,,,,,,,,,,,,,,,
3,,3,28,73,74,75,77,78,79,80,81,82,95,97,98,99,100,101,102,103,104,105,106,107,108,109,119,120,121,122,123,124,125,126,127,128,129,133,134,135,136,137,138,139,140,141,142,143,144,145,146,148,155,156,160,161,162,164,165,166,169,170,171,173
4,,4,5,6,7,8,9,10,11,12,13,14,15,16,17,18,19,20,21,23,24,27,30,40,41,42,43,44,47,48,54,58,87,89,172,,,,,,,,,,,,,,,,,,,,,,,,,,,,,
5,,2,35,36,37,63,64,65,66,67,68,69,70,71,110,111,112,113,114,115,116,117,118,157,158,159,167,168,,,,,,,,,,,,,,,,,,,,,,,,,,,,,,,,,,,,
