1,  16 17 18 21 22 84 85 86 87 88 89 90 91 92 93 94 95 96 98 101 131;
2,  1 2 3 6 24 25 26 27 28 29 30 43 47 49 50 51 52 53 55 56 58 59 61 62 63 64 71 72 75 79 110 117 119 120 121 122 127 129 130;
3,  4 5 7 8 9 10 11 12 13 14 15 19 20 23 57 60 73 74 76 77 78 80 81 82 83 97 99 100 102 103 104 105 106 107 108 109 111 112 113 114 115 116 132;
4,  35 36 37 38 39 41 67 68 128;
5,  31 32 33 34 40 42 44 45 46 48 54 65 66 69 70 118 123 124 125 126;
